ZOOTOMIES	Z UW T OW M IY Z
ZOOTOMIST	Z UW T OW M IH S T
ZOOTOTEMISM	Z UW T AH T AH M IH Z AH M
ZOOTOXIN	Z UW T AA K S AH N
ZOOTROPHY	Z UW T R OW F IY
ZOOTROPHIC	Z UW T R AH F AH K
ZOOXANTHELLA	Z UH K S AH N TH EH L AH
ZOOXANTHELLAE	Z UH K S AH N TH EH L IY
ZOOXANTHIN	Z UH K S AE N TH AH N
ZOOZOO	Z UW Z UW
ZOPHOPHORI	Z AH F AA F AH R IY
ZOPHORI	Z AA F AH R IY
ZOPHORUS	Z AA F AH R AH S
ZOPILOTE	Z AA P AH L OW T
ZOQUE	Z AA K
ZOQUEAN	Z AA K AH N
ZORAPTERA	Z AH R AE P T AH R AH
ZORGITE	Z AO R JH AY T
ZORI	Z AO R IY
ZORIL	Z AO R AH L
ZORILLA	Z AH R IH L AH
ZORILLAS	Z AH R IH L AH Z
ZORILLE	Z AO R AH L
ZORILLES	Z AO R AH L Z
ZORILLINAE	Z AH R IH L AH N IY
ZORILLO	Z AH R IH L OW
ZORILLOS	Z AH R IH L AH Z
ZORILS	Z AO R AH L Z
ZORIS	Z AO R AH S
ZOROASTER	Z AH R OW S T AH R
ZOROASTRA	Z AH R OW S T R AH
ZOROASTRIAN	Z AH R OW S T R IY AH N
ZOROASTRIANISM	Z AH R OW S T R IY AH N IH Z AH M
ZOROASTRIANS	Z AH R OW S T R IY AH N Z
ZOROASTRISM	Z AH R OW S T R AH Z AH M
ZOROTYPUS	Z AH R AA T AH P AH S
ZORRILLO	Z AO R IH L OW
ZORRO	Z AO R OW
ZORTZICO	Z AO R T S AH K OW
ZOSMA	Z AA Z M AH
ZOSTER	Z AA S T ER
ZOSTERA	Z AA S T AH R AH
ZOSTERACEAE	Z AA S T AH R EY S IY
ZOSTERIFORM	Z AA S T EH R AH F AH R M
ZOSTEROPINAE	Z AA S T AH R AA P AH N IY
ZOSTEROPS	Z AA S T AH R AH P S
ZOSTERS	Z AA S T AH R Z
ZOUAVE	Z AW EY V
ZOUAVES	Z AW EY V Z
ZOUNDS	Z AW N D Z
ZOWIE	Z OW AY
ZS	Z IY S
ZUBENESCHAMALI	Z UW B AH N AH S AE M AH L IY
ZUBR	Z AH B R
ZUCCARINO	Z AH K AE R AH N OW
ZUCCHETTI	Z AH K EH T IY
ZUCCHETTO	Z AH K EH T OW
ZUCCHETTOS	Z AH K EH T AH Z
ZUCCHINI	Z UW K IY N IY
ZUCCHINIS	Z UW K IY N IY Z
ZUCCO	Z UW K OW
ZUCHETTO	Z AH CH EH T OW
ZUDDA	Z AH D AH
ZUFFOLO	Z AH F AH L OW
ZUFOLO	Z UW F AH L OW
ZUGTIERLAST	Z AH G T IY R L AH S T
ZUGTIERLASTER	Z AH G T IY R L AE S T AH R
ZUGZWANG	Z AH G Z W AH NG
ZUISIN	Z UW S AH N
ZULEIKA	Z UW L IY K AH
ZULHIJJAH	Z AH L HH IH JH AH
ZULINDE	Z UW L AH N D
ZULKADAH	Z AH L K AH D AH
ZULU	Z UW L UW
ZULUDOM	Z UW L UW
ZULUIZE	Z UW L AH W AY Z
ZULUS	Z UW L UW Z
ZUMATIC	Z UW M AH T AH K
ZUMBOORUK	Z AH M B AH R AH K
ZUNI	Z UW N IY
ZUNIAN	Z UW N IY AH N
ZUNYITE	Z UW N AY AY T
ZUNIS	Z UW N AH S
ZUPANATE	Z UW P AH N EY T
ZURICH	Z UH R IH K
ZURLITE	Z AH R L AY T
ZUTUGIL	Z UW T Y UW JH AH L
ZUURVELDT	Z UW AH R V AH L D T
ZUZA	Z UW Z AH
ZWANZIGER	Z W AA N Z AY JH AH R
ZWIEBACK	Z W IY B AH K
ZWIEBACKS	Z W IY B AH K S
ZWIESELITE	Z W IY S AH L AY T
ZWINGLIAN	Z W IH N G L IY AH N
ZWINGLIANISM	Z W IH N G L IY AH N IH Z AH M
ZWINGLIANIST	Z W IH N G L IY AH N AH S T
ZWITTER	Z W IH T AH R
ZWITTERION	Z W IH T IY R IY AH N
ZWITTERIONIC	Z W IH T IY R IY AH N AH K
